11111111111111111111111111
10000000000000000000000001
10100000000000000000000001
1100N000000000000000000001
11111111111111111111111111
