111111111
100000001
100000001
101000001
101000101
1010N0001
111111111
