11111111111
10000000001
10000000001
10100000001
10100000101
1010N000001
10100000101
11111111111
